text	category
Teenager Suvir Mirchandani Shows US Government How To Save £240 Million  ...	t
2014 Mercedes-Benz B-Class Electric Drive Priced From $41450	t
AMERICAN IDOL: RECAP FOR MAY 8, 2014	e
AAA Michigan: Gas prices fall about 9 cents in past week; statewide average is  ...	t
The Sentinels Attack in This Opening Battle from 'X-Men: Days of Future Past  ...	e
The Colbert Report To Reveal New Marvel Comic	e
eBay data breach under investigation by Florida Attorney General	t
Justin Bieber Blackmailed! You Won't Believe How Much $$$ This Extortionist  ...	e
Federal Appeals Court Upholds Rajat Gupta Conviction	b
Michael Jackson's fortunes growing five years after death	e
Sisaundra Lewis – Don't Let The Sun Go Down On Me – The Voice Top 12 Live  ...	e
Dropcam acquired by Google Nest	t
Baby Gates Could Lead To The ER, New Study Says	m
Fed intends to keep interest rates low long after tapering ends	b
Existing Home Sales Rebound, Inventory Increases	b
Canadian teen tries to exploit Heartbleed vulnerability, arrested	t
US, UK advise netizens to avoid Internet Explorer	t
"RECAP: Game of Thrones, ""First of His Name"""	e
NASA testing 'flying saucer' to land heavy payloads on Mars	t
A German magazine is reporting that families that control Fiat and Volkswagen  ...	b
VIDEO: Jane Goodall on Disneynature's 'Bears' Film	e
Woman dies of apparent overdose at Coachella festival	e
Don't use Internet Explorer, warns US government	t
VOICE VIEWS: Josh Kaufman scores controversial victory on The Voice	e
Google's self-driving cars hit city streets	t
Paul McCartney apologises as mystery illness forces him to cancel gigs	e
Jada Pinkett-Smith defends Willow Smith, shirtless Moises Arias photo	e
Hummus, walnuts at Trader Joe's, Target recalled over possible listeria	m
Target CEO steps down in aftermath of customer data breach	b
Tablet glee dips: Apple and Samsung battle budget slates	t
Saldanha went deep into the Amazon for 'Rio 2'	e
Apple Inc., Google Inc Maps Spat Spills Over To CarPlay	t
Profile: The 50 Year Limited Edition 2015 Ford Mustang	t
CURRENCIES: Pound Spikes On Rate-hike Talk	b
A foreign health worker died of MERS and five others were infected in UAE	m
Lovely first teaser for the Peanuts movie	e
Transformers facts: Michael Bay's big bang theory lives on	e
Pesticides and autism linked: study	m
NY homeless angry at China tycoon's 'publicity stunt'	b
Kelly Clarkson Welcomes Baby Girl	e
UK jobless drop in pre-budget boost	b
Farewell, Grand Caravan: Why I'll miss this minivan	b
Fixing Web's security flaw time-consuming	t
Amazon to let users shop via Twitter	b
Now Trending: Did Miley Cyrus go too far with onstage joke about date rape?	e
Yellen Says Constraining Fed Would Be a 'Grave Mistake'	b
In brief: French leader takes key role in Alstom merger	b
Sunbeds 'main cause of skin cancer'	m
Microsoft jumps on wearables bandwagon – everybody's doing it, sure why not?	t
Particle physics: Experiments at the Large Hadron Collider give shape to the  ...	t
Gold Climbs To 19-Week High On Ukraine Tension	b
“The Hobbit: The Battle Of Five Armies” Trailer: The Epic Conclusion To The  ...	e
Incidents force security changes at World Trade Center	b
Alibaba Gets a Bounce Ahead of Massive IPO	b
IMF, Downgrading U.S. Growth Outlook, Cautions Investors About Interest Rates	b
Netflix and Comcast- the streaming race just got faster	t
Investors to seek clues from Fed on rate increase	b
Preggie Eva Mendes glows at 40	e
Review: Muppets Most Wanted	e
Report: Brad Pitt and Angelina Jolie Teaming Up for Movie Project	e
AT&T to Acquire DirecTV, for a Whopping $48.5 Billion	b
Lawmakers Pressure the FDA to Regulate E-Cigs With New Report	m
Gas Prices Continue to Soar; Where to Find it Cheap in Carlsbad	t
A Closer Look At The Green Goblin In 'Amazing Spider-Man 2' Reveals  ...	e
Paul Walker's mother wants custody of his daughter; claims his ex has 'drinking  ...	e
'Sharknado 2' whips up Twitter feeding frenzy	e
Genghis Khan's Expansionist Empire Aided by Ideal Climate – Study	t
UPDATE 3-BlackBerry reports better-than-expected results; shares surge	b
Are You Affected By The Nokia Lumia 2520′s Faulty Charger Issue?	t
Louisville, Memphis, Baton Rouge top allergy list	m
Today's EMU inflation data suggests CPI should stay below 1% for a while - BNP  ...	b
Destiny's Child's 'Say Yes' Music Video Has Dropped!	e
Peaches Geldof dies aged 25: her life in pictures	e
State gets federal money for health center improvements	m
UN panel says worst effects of climate change are yet to come	t
Syfy's SHARKNADO 2 Delivers Record-Setting Ratings; 3.9 M Total Vieweres	e
VIDEO: Brian Williams Talks Edward Snowden Interview & More on LATE NIGHT	e
Messy protest shows rising Hong Kong fears about China	b
Teardown Reveals Samsung's Galaxy S5 Costs Only $256 to Manufacture	t
Chris Evans plans to retire from acting after The Avengers 3	e
Toxic water treatment system at Japan nuclear plant halted again	b
3D printer to fly to space in august, sooner than planned	t
"Gary Oldman Slams ""Political Correctness,"" Calls Dark Knight Movies ""Work"""	e
GM recall persists, now for Camaro ignition switches	t
Amedisys Finalizes Settlement Agreement With Government	m
AOL Down 24% As Q1 Earnings Beat On Sales Of $583M But Miss EPS On $22  ...	b
Fake Tinder account 'Nurse Nicole' encourages men to see a doctor	m
A whole new game: 'Divergent' in theaters Friday	e
Bikini Bump! Kourtney Kardashian Shows Off Her Growing Belly in the Hamptons	e
Indian manufacturing output hits 3-month high: survey	b
Murdoch eyes $14-bn deal to merge pay-TV units	b
LIST: 7 things you didn't know about the Wizard of Oz as the beloved movie turns  ...	e
WATCH: Bungie's Destiny Lets Players Build Their Own Legend	t
Apple updates MacBook Pro laptops, cuts price of older model	t
Selena Gomez Jenner Feud Explained! Justin Bieber Hookup Or Coachella  ...	e
The Hobbit: The Battle of the Five Armies trailer shows war raging in Middle Earth	e
The best free iOS apps for March 28, 2014	t
The best and worst places in the world to be a mother	m
Newly Insured in 2014 Represent About 4% of US Adults	b
AC/DC Issue Statement on Malcolm Young and Their Future	e
Editorial: Keep the LIRR talks going	b
India needs better cyber police	t
Google To Launch Health Service like Samsung, Apple - Google Fit	t
Taylor Swift Hosts Star-Studded Fourth of July Party; Selena Gomez Not Invited  ...	e
Nexus ain't dead, new device to join Android L later this year	t
Siemens says standing by should Alstom-General Electric talks collapse	b
Cat lovers to have 'smart' way to feed beloved pets	t
Recovery of EU Unemployment Expected Faster	b
Oklahoma Ranks 4th Worst City For Spring Allergies	m
Watch Andrew Garfield-Emma Stone French Kiss In SNL	e
Michael Jackson's Xscape a reminder of the man's gift	e
Chris Christie shows off his dance moves as he joins Jimmy Fallon for hilarious  ...	e
Julia Louis-Dreyfus explains Rolling Stone blunder	e
Project Ara to launch $100k module contest to focus minds of developers	t
Minn.-based Medtronic to buy Irish medical-device manufacturer for $42.9B	b
Miley Cyrus Apologizes For Being Sick	e
Investigation finds more anthrax lapses at CDC	m
Denver airport's largest airlines are at opposite ends of the passenger complaint  ...	b
Major Averages Close In The Red, Nasdaq Underperforms	b
26 held for strike related crimes	b
Amazon's smartphone launch offers a prudent platform for growth	b
Miley Cyrus Postpones Remaining Dates on Bangerz Tour	e
Drug Company Will Provide 7-Year-Old With Cancer Drug	m
Chinese Government to Ban Sales of Windows 8	t
New research says more moms stay at home	b
Twitter user numbers grows to 271m	t
Sovaldi: Who's to Blame for the $1000 a Day Cure?	b
Harvard study links pesticides to bee deaths	t
Sprint prepares for 'price war'	t
Climate Change, EPA Rules Focus of McCabe Confirmation Hearing	t
Yampa Valley Autism Program hosting Wednesday event	m
'The Bachelorette': Which of the Final 3 Men Did Andi Send Home Early?	e
Harrison Ford injury to halt production on 'Star Wars: Episode VII' for 2 weeks  ...	e
Amazon Prime Music makes a surprise launch	e
Robbers loot Samsung plant in Brazil, steal products worth $36 million	t
What to Look for in Tesla Motors Inc.'s First-Quarter Results Today	b
Katy Perry launches Metamorphosis Music label, announces Ferras as first signee	e
Edsel Ford And Ford Racing NASCAR Drivers Comment On Favorite Mustang  ...	t
"Hilary Duff: ""Chasing the Sun"" in Comeback Music Video!"	e
Malaysia: Stolen passport user was asylum seeker	b
Popeye's pays $43 million to Copeland family for recipes	b
"Jonah Hill Apologises For Using Homophobic Slur: ""It's Not Part Of My Vernacular"""	e
Police Say Peaches Geldof's Death 'Unexplained'	e
Willow Smith, Moises Arias Are Like Family, Brother Jaden Smith Is His Best Friend	e
Warmer temperatures can lead warmer tempers, worsening global security, UN  ...	t
No fireworks ban for county residents	e
'If I have one more drink I'll die'	e
Now Even Grown-Ups Can Have a Night at the Museum	e
Mammal Fertilization begins with Juno and Izumo	m
On Deck This Week: Fed Policy - Analyst Blog	b
Opie And Anthony's Anthony Cumia Fired For Racial Tweets	e
June job hires surge	b
'Avengers: Age Of Ultron': Get Your First Look At Quicksilver And Scarlet Witch	e
Woman gets help from stranger at Walmart	b
Michaels craft stores confirm security breach	b
Austin MotoGP: Marquez from Espargaro in opening practice	t
With tighter focus on game software, E3 sorts out winners and losers	t
Obama guidance & press schedule, April 8, 2014: Women Equal Pay	b
Screen Legend Dies at 93	e
"'Game of Thrones' 4.02 Episode Review and Recap: The Lion and the Rose"""	e
French economist's book on inequality tops Amazon list	b
Ben Affleck Looks Suspicious in New Trailer for Gone Girl (VIDEO)	e
Study: Over-Treating Medicare Patients May Cost Billions	m
Watch: TomoNews takes on the Bieber-Yasukuni Shrine fiasco	e
Let 'Weird Al' Yankovic Teach Your Students Grammar	e
Euro falls to 3-month low on German data, EU election uncertainty	b
Deadly superbugs survive on planes, study says	m
Kellogg's forced to change “all-natural” labels on Kashi products	b
Google Rolls Out OK Google To Android Lock Screens	t
Mega-Earth 17 times heavier than our planet discovered	t
What was the first student loan?	b
Rolls-Royce order book hurt by Airbus order cancellation	b
Amazon's New, Powerful Enemies	b
Smarthphone Sober App Will Help Recovering Alcoholics New Study Shows	m
Channing Tatum Interview For '22 Jump Street'	e
Moto X+1 Rumored To Feature Camera With Optical Zoom, 3D UI	t
Hugh Jackman wants Wolverine in next Avengers film	e
Marathon Petroleum to buy Hess's retail business for $2.87-billion	b
Labor Dept. cuts coal dust levels	m
Hoosier Josh Kaufman wins 'The Voice'	e
Bryan Cranston Helps Fan Get a Prom Date	e
Hillary Clinton Joins Barbara Walters as She Bids Farewell	e
Apple's 'Back to School' promotion goes live with $100 gift cards for Mac  ...	t
Euro inches up vs dollar in face of pressure on the upside	b
Quantum Break escapes Xbox TV cull	t
Nissan Profit Forecast Misses Estimates on Fading Yen	b
Wall Street edges lower after record; Boeing drags	b
8 hours ago • By MARK KENNEDY	e
Gareth Edwards and Gary Whitta Onboard for Star Wars Stand-Alone Film	e
Brooks announcement hints at 'comeback' tour	e
'Evil' finale saves us from boredom	e
Justin Bieber Skips Out On Toronto Court Appearance After Weekend Partying  ...	e
Study finds childhood vaccines safe, side-effects rare	m
Coldplay's Chris Martin is a sorcerer in 'Magic' music video - watch	e
'Modern Family,' 'Breakig Bad' win top Emmys	e
Cameron Diaz Sounds Off on Gwyneth Paltrow and Chris Martin Split (VIDEO)	e
Draft Day is a first round pick	e
"Ciara shows off her dance moves with baby bump, singer says, ""My belly is so  ..."	e
Disney Defense This Former Disney Actor Was Definitely Not Raped By Bryan  ...	e
Game of Thrones' Courtroom Drama	e
Robert Downey Jr. Responds To Son's Arrest	e
Microsoft Works To Cut Down Cybercrime	t
"Lupita Nyong'o is People's ""Most Beautiful"" woman!"	e
Do you own a GM recalled car?	b
Comcast-TWC Merger: Business-Services Market Prepares for Potential Shake-Up	t
GM's new CEO facing grilling by Congress	t
There Went The Bride, Britney Spears' Little Sister Jamie Lynn Is Officially A Wife!	e
Biggest Seabird Found? Pelagornis Sandersi Sported 21-Foot Wingspan	t
Zebra Tech Snags Motorola's Enterprise Unit	b
Lindsay Lohan Destroys A Car Over 'How I Met Your Mother' Ending	e
Only part of Health Homes integration program launches in Kansas	m
Imperial War Museum's flagship site to reopen this weekend after first stage of its  ...	e
Analyst Upgrades: QUALCOMM, Inc., Wal-Mart Stores, Inc., and Pandora Media  ...	b
Latest Fed survey sees improved U.S. economy	b
Ellen DeGeneres confronts Chelsea Handler in the shower as 'Chelsea Lately  ...	e
Bryan Cranston treads lightly, helps teen scare a prom date	e
"The Flaming Lips and Miley Cyrus Played ""Yoshimi"" Together Again, Got Pelted  ..."	e
BMS enters two immuno-oncology deals	m
"UPDATE - Barclays shares sink as lawsuit filed over its ""dark pool"""	b
Alibaba files for U.S. IPO	b
AT&T's Motives for Fast Fiber Expansion Come Under Scrutiny	t
Facebook in new 'EXPERIMENT' drama: A sticky Buy button	t
Peter Gabriel, Kiss lead new class into Rock Hall	e
Toyota agrees to record $1.2B settlement	t
Beyonce Sends Her Blessings to Kanye West and Kim Kardashian [PHOTO]	e
Abbott, Abe announce trade partnership	b
Uber strikes partnership deal with AT&T, will move drivers to AT&T network	t
eBay and Icahn settle proxy fight	b
JD.com soars in 1st day of Nasdaq trading	b
Cultural icon Casey Kasem dies at age 82	e
Surfing and sailing pioneer Hobart Alter dead at 80	e
Stress Test Shows 29 Banks Meet or Top Capital Target	b
What Will Best Buy Do Post-Earnings?	b
Tainted treats linked to pet deaths, illnesses	m
Twitter Beats the Street – TWTR	b
New Kids on the Block get a docu-series on a boat	e
Optimism sends S&P 500 to record	b
'Neighbors' movie review: Crude jokes and bromances abound	e
Oil nears $107 as supply offsets global tensions	b
'Brady Bunch' actress Ann Davis remembered	e
Jeff Boyer Urges Drivers of Recalled Vehicles to Use a Single Key	t
Turkish film 'Winter Sleep' wins Cannes' biggest prize	e
Kim Kardashian, Kanye West Magazine Cover: Anna Wintour Okay With  ...	e
Should we lower our expectations for new Michael Jackson album 'Xscape'	e
Surface Pro 3 Review Roundup: Does This Device Come Close To Replacing  ...	t
NY Dealers Reach Pact with Tesla, Direct-to-Customer Stores to Stay Open	b
Boeing says final assembly of its 787-10 jetliner will take plane in South Carolina	b
'The Bachelorette' finale review: Did Andi Dorfman pick Nick Viall, Josh Murray  ...	e
IBM is Apple's simplest solution to selling more iPads	t
Some docs welcome CMS data dump	m
Tesla Criticizes Missouri Auto Dealers In Newest Battle On State Level	b
Solange Knowles makes red carpet return after elevator fight	e
'Jupiter Ascending' Trailer 2: Channing Tatum and Mila Kunis Expand Your  ...	e
Home > Robert Downey Jr > Robret Downey Jr's Son Arrested	e
A Reality of 'The Bachelor': One Thing Juan Pablo Got Right	e
Is 'Divergent' the next big thing? Well, it does show promise	e
US Headache Sufferers Get $1 Billion Worth Of Brain Scans Each Year	m
'Game of Thrones' Season 4 breaks piracy record	e
Kim K finally lands the cover	e
Venture capital highest since 2001	b
Apple's Maps App May Have Helped Discover the Loch Ness Monster	t
Valeant to bid for Botox maker Allergan; activist investor Ackman discloses $4.1B  ...	b
Chiklis joins 'Coven' principals for next 'Horror'	e
Facebook privacy response awaited	t
Paltrow breaks silence after split	e
Toyota admits hiding safety defects; penalised $1.2 bn	t
Is Universal's Second Harry Potter Attraction a Disney Killer?	e
Bridge scandal testimony from Port Authority leader postponed	b
Detroit's new debt-cutting plan reduces pension cuts, reflects frantic pace of  ...	b
Japan's trade surplus is lowest on record	b
Researchers say blood test can predict suicide risk	m
Current Mortgage Rates at Wells Fargo for March 11	b
Actos Bellwether Trial: $9 Billion Verdict for Plaintiffs	b
Nintendo launching new hardware for 'emerging markets' next year	t
Music Feature Record Store Day 2014: Digital Spy's top 10 picks	e
Let's not forget the true meaning of Easter	e
Hawaii prescribes least painkillers, CDC says	m
'Dancing with the Stars' 18 results: Was Danica McKellar, Candice Cameron  ...	e
The Walking Dead: why season 4 was the most shocking yet	e
Deals of the day- Mergers and acquisitions	b
Internet measurement firm Renesys bought by Dyn	t
Sterling races higher vs euro after UK data, German inflation	b
Emmys 2014: 'Breaking Bad' takes Best Drama, Best Actor and three more to win  ...	e
Can This Growth Driver Push AstraZeneca Forward?	b
The Late Late Show with Craig Ferguson: Host Leaving in December	e
'The Voice' Season 7: Gwen Stefani Officially Confirmed as New Judge	e
Amazon Stands to Make Billions from Their New Smartphone	t
Deadly Ebola outbreak continues to spread beyond Guinea	m
Climate talks: China to set an absolute cap on CO2 emissions	t
MPs bicker over IPCC report on causes of climate change	t
Apple unveils Swift, a new programming language for iOS, Mac	t
Casey Kasem, You've Truly Reached The Stars	e
Harris victims describe impact of abuse	e
Verizon XLTE Turned on in 50 More Cities Today – Available in Over 300 Markets	t
DARPA Robotics Challenge Finals 2014: Google's SCHAFT Will Be Self-Funded  ...	t
Facebook Acquires Fitness-Tracking App to Build Mobile Portfolio	t
Macklemore apologizes for mocking Jews	e
Watch: Pregnant Hayden Panettiere reveals baby's sex on Emmys red carpet	e
David Arquette gets engaged to Christina McLarty	e
Court rules against Japan	t
Channing Tatum and Jonah Hill In Penis-Kissing Bet	e
Chernin, AT&T Partner in Online Video	b
Powdered Liquor: Now Legal But Won't Be In Your Margarita Soon	e
The Hunger Games: Mockingjay – Part 1 First Trailer	e
Boeing flies straight despite profit fall	b
Human nose can detect 1 trillion odours: study	m
A common psychiatric disorder becoming more popular among young adults	m
Best Samsung Galaxy Note 3 Cases Right Now	t
Lindsey Vonn is close friends with boyfriend Tiger Woods' ex-wife Elin Nordegren	e
Pig virus causes bacon price hike	b
Nokia X vs. Nokia Lumia 520 – Comparison Review	t
Taylor Swift gets sexy at ACM Awards	e
Tony Bennett and Lady Gaga record 'Cheek To Cheek'	e
Smartphones occupy 87% of american pockets, report	t
Ex-Goldman Sachs banker replaces Twitter CFO in continuing shakeup	b
Kristen Bell, Jenna Dewan And More Pose Nude For Allure	e
Tesla Suppliers List: These 26 Companies Help Make a Model S Sedan	b
'The Other Woman' review: Leslie Mann carries Kate Upton, Cameron Diaz in  ...	e
Would-be online house-hunting giant has brokers scared	b
Ticks, Fleas, Mosquitoes -- Oh My! Protecting Your Dog Against External Parasites	m
Second Apple Patent Suit Vs. Samsung Ropes In Google	t
Fox's Carey Said to Drop Bomb on Bewkes Over Lunch	b
Miley Cyrus Mourns To Giant Replica Of Her Dog Floyd On Stage	e
Apple Suppliers to Start Making Large-Screen iPhone 6 in July: Report	t
Why polio is making a comeback	m
Soybeans fall for 7th day as US crop thrives	b
Beyoncé Lands TIME's 100 Most Influential Cover! Bow Down!	e
ECB stimulus comes with hidden message on interest rates	b
Emirates agrees to buy 150 Boeing 777X planes	b
JPMorgan's Dimon suffering from throat cancer	b
Report: Kanye West's train delayed by four hours	e
Alibaba roadshow could be a bumpy ride for banks	b
It will make you wince. It will make you laugh	e
Neil Young's PonoMusic Player Announces Pre-Order Date	e
Lindsay Lohan's Reality TV Show 'Lindsay' Debuts To Poor Ratings	e
Excessive Drinking Causes 10 Percent Of Deaths In Working-Age Adults	m
5-Year-Old Finds Xbox One Password Bug	t
Argentina Will Negotiate With Holdout Investors	b
Steve Jobs Told Top Executives That Apple Would Not Make A TV	t
Healthcare.gov Picks Lousy Time for Scheduled Maintenance	b
Actress Amy Adams Gives Up 1st Class Seat to Soldier on Detroit Flight	e
Economic Watch: Inflation in Check, Homebuilder Confidence Rises	b
Amazon has beaten Google to £600m Twitch acquisition	t
Inhaled insulin approved by FDA	m
Kimye skips out on bill; Solange talks elevator incident	e
'He had a cot in the basement and he'd be telling stories non-stop'; Saskatoon  ...	e
US economy back on track with strong rebound	b
Zac Efron Kissing Girlfriend Michelle Rodriguez PHOTOS 2014: Drug Free  ...	e
Star Wars 2015: What we know and more as rumours say Chewbacca is back	e
Google builds their own self-driving car without steering wheel	t
Deals, hearty earnings elevate stocks	b
Twitter buys social data provider Gnip, stock soars	t
GM recalls 2.4 million more vehicles	t
This fall, Californians can get licenses for their driverless cars	t
Kids' shirt resembling Nazi camp garb pulled by retailer	e
Ohio Man Raises $40000 (and Counting) in Viral Kickstarter Campaign	e
Microsoft Surface Pro 3 vs. Apple iPad Air: Tablet Showdown	t
Sarepta Revives Hopes For Muscular Dystrophy Drug	m
EBay Plans to Build on Braintree's Venmo as PayPal Seeks New Audiences	b
In Medicaid expansion battle, Maine Republicans embracing health care  ...	m
Infamous urban legend turns out to be true	t
Amazon Smartphone Rumors Now Include Photos	t
Has Nicole Kidman had a boob job? Actress shows off impressive cleavage at  ...	e
US Fiscal Authorities Recognize Bitcoin. Bitcoin Will Be Taxed	b
Jay-Z and Rachel Roy: Both Attending Kimye Wedding!	e
In brief: Chicken with link to salmonella recalled	m
NASA giving global warming satellite another try	t
Ex-Im Chairman Hochberg Defends Against Republican Foes	b
Chia Recalled for Salmonella Contamination	m
BlackBerry launches low-cost smartphone to revive sales	t
Air pollution led to 7 million deaths in 2012: WHO	m
Google-Owned Nest Buys Dropcam, a Home-Monitoring Startup, for $555 Million	t
Corn Export Sales Decline, Soybeans Increase	b
FCC's New 'Net Neutrality' Rules Allow for Preferred Traffic -- 3rd Update	t
US employers add 209000 jobs, rate rises to 6.2%	b
Update on Lohan's List of Men: Lindsay Lohan a Paid Escort?	e
Climate changes on Day 3 of U.S. mayors meeting in Dallas	t
Samsung Factory Raid Nets £21m For Armed Robbers	t
OMG: Kim Goes Completely Braless!	e
Scientists discover evidence that could support the Big Bang explosion as the  ...	t
Tesco follows up Hudl tablet with a smartphone	t
Heavy drinking puts Sum 41 singer Deryck Whibley in hospital	e
Road Rage Truck Driver Gets in Accident	t
New Microsoft CEO Nadella impresses Wall Street, stresses challenges	b
Marvel's First Female Superhero Film Teased By Guardians Of The Galaxy  ...	e
"Entertainer Rolf Harris tells court of ""sexual chemistry"" with alleged"	e
Game of Thrones Director Explains Why We Didn't See The Book Epilogue	e
Valeant, Ackman looking to buy Botox maker Allergan in deal worth about $48B	b
Libya says halts tanker outside rebel port; rebels deny it	b
Rip Dave Brockie	e
Gold Down Ahead of Federal Reserve Minutes	b
Student Claims Yale Threatened Forced Medical Leave over Her Low Weight	m
Gaming takes center stage for Oculus VR at E3	t
Detailed restructuring plan of Malaysia Airlines expected to be announced by  ...	b
E-Cigarettes Could Get Hit With Regulations From FDA	m
Game of Thrones' Horrible Humans Somehow Get More Horrible	e
HBO Content Now Available To Prime Customers	e
There's Only One Way We Might Be Interested in the Just-Announced 'Mrs  ...	e
Amazon unveils new smartphone with 3-D capabilities	t
VIX Shows No Fear	b
Justin Bieber under investigation for alleged theft	e
Obama Climate Plan Relies on States	b
NZ dollar jumps above 88 US cents after Fitch upgrades outlook to positive	b
Hillary Clinton to Make Surprising Fox News Appearance	b
Jennifer Lopez Makes Her Pick for the Winner of American Idol 2014	e
Pfizer's New Breast Cancer Drug Shows Promise	m
Israeli transsexual singer sparks parents' ire with 'bar mitzvah' video	e
Markets Higher - Closing News - 06/17/14	b
Climate change has arrived	t
Lady Gaga has been enlisted in California's drought relief efforts	b
Mobile advertising drives Facebook earnings surge	b
Global AIDS Death Toll Falls To 1.5 Million In 2013 – UN	m
Remainder of Miley Cyrus' U.S. tour postponed due to illness	e
Fewer economists believe US policy on right track	b
Up in the sky! It's a bird, it's a plane, it's a Facebook drone!	t
UK must “heed” climate scientists warning say MPs	t
Do You Think Google Inc, Facebook Inc, Apple Inc. Know More About You?	b
Renaissance Woman! Kim Kardashian Talks Juggling Work With Motherhood  ...	e
Google Play Gets a 'People' Section for App Suggestions from Your Friends	t
Macmillan Cancer support responds to European breast cancer mortality rates	m
Mozilla Petitions the FCC with a Net Neutrality Plan of its Own	t
Maersk First-Quarter Profit Jumps on Lower Costs, Higher Volumes	b
3D Printer 'Mink' that lets you print Make-up from your Computer!!	t
Watch: President Snow's address in the teaser for 'The Hunger Games  ...	e
Valve's Steam Controller delayed to 2015	t
VIDEO: Netflix CEO Calls For Net Neutrality, Blasts Abusive ISPs	t
Labeling girls fat ups their risk to become obese later	m
ORWELL'S SILICON VALLEY	t
Sony unveils its answer to Oculus Rift	t
Flaw in 'Watchful Waiting' Approach for Prostate Cancer	m
Hyundai is recalling 883000 Sonatas - KCTV5	t
Fiat Chrysler continues U.S. sales increase streak	b
China's Alibaba seeks blockbuster IPO in US	b
What's Wrong With Cisco and IBM Today? Blame the NSA	b
Seth MacFarlane sued over 'Ted' character by production company who claims  ...	e
National Record Day celebrated at Culture Shock	e
'Edge Of Tomorrow' Is The Right Kind Of Rerun	e
Texas' largest electric utility files Ch. 11 reorganization	b
'Burger King baby' finds birth mom, feels pure joy	t
Colin Firth quits Paddington Bear movie 9:41AM	e
Amazon.com Raises the Stakes Against Apple in Streaming	t
GM To Pay At Least $1M For Each Death	t
After FBI tipoff, police in 16 countries arrest 97 for suspected links to  ...	t
Kevin Bacon's 'Footloose' Entrance On 'The Tonight Show' (Video)	e
Fox to broadcast three-hour live musical version of Grease with young ensemble  ...	e
Search planes find no sign of missing airliner at spot located by China	b
Amazon on Hachette Fight: Feel Free to Shop Elsewhere	b
Del. Governor Signs Teen Tanning Bill	m
'The Voice': Orlando singer electrifies	e
Milk delays osteoarthritis progression	m
Microsoft Corporation (MSFT) Pre-Earnings: Bing Grew More Than Google	b
Facebook for Windows Phone gets updated once again with custom notifications	t
Sony Confirms Battery Fire Risk with Vaio Fit 11A Laptop	t
Chinese cup sold for £21.7m	e
Marvel defends decision to introduce female Thor	e
Report Finds Climate Change Impacting Entire Planet, Raising Risk Of Disasters	t
GM recalls another 824000 vehicles over faulty ignition switch	b
Destiny Beta Trailer Released to Celebrate Bungie Day	t
"Mad Men: Let's Talk About ""The Monolith"""	e
Miley Cyrus escapes injury as her tour bus bursts into flames	e
Top Banana! World's Biggest Producer Created	b
Lena Dunham might quit acting when HBO's 'Girls' wraps	e
'Noah' Movie review: As promised, it's not a Biblical movie, but worse – it's not a  ...	e
Mystery of 1700s Boat Found at World Trade Center Site SOLVED	t
Nigerian GDP Jumps 89% As Economists Add In Telecoms, Nollywood	b
'Fast and Furious 7' Trailer: Paul Walker's Last Scenes Revealed By Universal  ...	e
Honda recalling 886815 Odyssey minivans because of fuel leak risk	t
Apple's Curious Acquisition	t
Red Wine Antioxidant Fails to Lengthen Lives, says study	m
Harley-Davidson Introduces First Electric Bike: Project LiveWire	t
Google Glass Goes On Sale... For a Day	t
Ex-BP manager settles Gulf spill insider trading case	b
Samsung replaces mobile design chief	t
Novartis 'transforms' itself with multi-billion-dollar GSK, Lilly deals	b
Dept. of Health: Burning truths about holiday safety	e
Oculus VR and Palmer Luckey being sued by CTO's former employer (update)	t
Running of the Bulls festival gets underway	e
Wizarding World of Harry Potter - Diagon Alley grand opening timings for guests  ...	e
Movie Reviews: 'The Other Woman,' 'Brick Mansions'	e
Air pollution risk greater than thought	m
NTSB Faults Pilot 'Mismanagment' in Asiana Flight 214 Crash at SFO	b
Catching Up With Jack Reynor and Nicola Peltz on Transformers: Age of Extinction	e
Saudi Arabia announces new Mers death	m
Artists such as Ellie Goulding, Grouplove, ZZ Ward and Aloe Blacc perform	e
Miley Cyrus Wears A Weed Onesie While Fighting Avril, The Internet Rejoices	e
need2know: Flat local open ahead	b
Marc Webb Says He Wants Kraven For The Amazing Spider-Man 3	e
Morgan Freeman, But on Helium	e
It's sink or swim for Hollywood version of Noah and the flood	e
Netflix opposes Comcast-Time Warner Cable merger	b
Supreme Court Takes on Aereo Streaming TV Case	e
LG G3 Unboxing Video	t
Change text size for the story	m
Sofia Vergara rebounds with 'True Blood's' Joe Manganiello	e
E4 partners with Nintendo to celebrate Mario Kart 8 release	t
Vodafone Sees Profit Dropping Amid Spending on Turnaround Bid	b
Scandal's Columbus Short May Face Charges After Bar Fight	e
Come visit FX's darkly fun 'Fargo'	e
Why The World Needs A Happiness Campaign To Live Better	e
Local residents on cancellation of Garth Brooks concerts	e
Uninsured Rate Drops To New Low As Obamacare Sign-Ups Surge	b
Diet soda better for weight loss than water, according to study funded by soda  ...	m
Hereâ€™s why Australia and New Zealand Banking Group has dropped 3% today	b
TMZ dissed for posting crash site video	e
Fiat shareholders approve name change	b
Peaches Geldof's haunting final column: 'I had the perfect life. It was and is bliss'	e
Justin Bieber cleared from robbery charges	e
Remote-Control Birth Control Is Coming	m
Egypt's government raises fuel prices by up to 78 per cent to address staggering  ...	b
Nobel-prize winning Colombian novelist Gabriel Garcia Marquez dies	e
Tori Spelling Opens Up For the First Time Post-Cheating Scandal (VIDEO)	e
Google Glass Explorer Edition goes on sale in the UK for £1000	t
Microsoft Releases - A Rollup of Microsoft's Biggest Hits and Flops	t
Carney signals earlier British rate rise, sterling soars	b
Did Edgar Wright walk away from Ant-Man because he wasn't happy with  ...	e
New Taiwan dollar rises to NT$30.162 vs. greenback	b
China Plans major Infrastructure and Transport Network Improvement	b
The End of Windows XP Support– Are You Prepared?	t
Kim Kardashian celebrates close friend Ciara's baby shower	e
Kim Kardashian & Kanye West's Marriage Is Getting Weirder by the Day	e
CDC Estimates 1 In 68 Children ID'd With Autism Spectrum Disorder	m
Normal Subway Service Resumes After Queens Derailment	b
Harry Potter is Back, Turning 34 This July	e
Ebola test proves negative again in Ghana	m
X-Men: Days of Future Past (3D)	e
9-Year-Old Shaves Head to Support Friend, is Suspended from School	m
US Wins WTO Dispute With China Over Autos, Parts	b
Review: Nokia X — A Messy Android Affair	t
Soul legend Bobby Womack dies	e
Draghi Increases Likelihood Of Further Easing	b
'Guardians Of The Galaxy' End Credits Sequence Leaked Online	e
Titanfall ships with 792p rendering	t
Selena to return to rehab? Justin Bieber not committed to Gomez	e
Kim Kardashian Celebrates Her Bachelorette in the Streets of Paris! Come See  ...	e
Stocks finish higher on earnings gains	b
Cleanup continues 2 months after deadly mudslide	t
US adds 209000 jobs in July, unemployment rate ticks up to 6.2 percent	b
Tesla Motors Inc (TSLA) Responds Positively to Open Letter With Suggestions	t
EUR/GBP Should Expect Further Downward Movement	b
Veep Power Rankings: 'Alicia'	e
Fort Bend ranked on of Texas' healthiest counties	m
Casey Kasem - Casey Kasem's Body Remains In Morgue	e
Nation&World briefs	t
Energy Drinks All The Buzz	m
Kim Kardashian, Kanye West set for secret wedding?	e
Iran demands Pakistan free abducted guards	e
Get it while it's hot: A restaurant in Chicago is serving a $100 grilled cheese  ...	e
Philip Morris buys Nicocigs	b
Surgeon general warns of melanoma surge	m
AstraZeneca shareholders upset at rejection of Pfizer offer (AZN)	b
MERS sickens UAE paramedics, Jordanian, more Saudis	m
Legendary cinematographer Gordon Willis dies at 82; see his finest work from  ...	e
'Foil,' Weird Al's Parody of 'Royals,' Isn't Entirely About Food – Watch The New  ...	e
Analysts predict Fox/Time Warner 'bloodbath'	b
Barbara Walters Sets 'View' Exit Date	e
Retailer withdraws child's shirt after some say it looks like Jewish concentration  ...	e
Michaels Confirms Security Breach in 3 Alaska Stores	b
Thor, Goddess of Thunder: Hammer-swinging Marvel superhero now officially a  ...	e
Google moves to cut prices of Android smartphones to under US$100	t
The World Wide Web: By the numbers	t
A look at the biggest fast-casual pizza chains	b
California Launch Of NASA Carbon-Monitoring Satellite Delayed Until 3 PM  ...	t
Ebola Outbreak Spreading in Africa	m
Xbox One makes hot debut as console war revs up	t
VOICE VIEWS: Ranking the Top 12 on The Voice	e
Chris Brown seen stumbling after awards show	e
9/11 Memorial Museum preps for opening	e
HTC looking for marketing boost by hiring former Samsung mastermind	t
WHO: Numbers infected by Ebola could exceed 20000	m
GUEST COMMENTARY: We need to ensure quality medical care for all	m
Op-Ed: Special interests and the Tesla ban in US states	b
Doctor awaiting trial among top Medicaid billers	m
Officials: Illinois man with MERS not contagious	m
China's JD.com IPO raises $1.78 billion, augurs well for Alibaba	b
Mental And Physical Toll Of Bullying Persists For Decades	m
Sycamore Wants to Buy Express	b
US allows oil exports for 1st time since 1970s: WSJ	b
Tech helped hospital contain MERS virus	m
Rob Kardashian reportedly has serious drug problem	e
Nine British Citizens on board Malaysian passenger plane- 295 confirmed dead	b
Webcam captures hatching sea turtles	t
Toned woman quits gym for being too fit	m
Zara Removes Child's 'Holocaust Pyjamas' from Sale Following Complaints	e
How Climate Change Has Devastated The World In One Map	t
Pilots lacked automation understanding in Asiana crash	b
Google Maps App for iOS and Android: Is Apple Maps in Trouble After Latest  ...	t
BNP to cut dividend, issue bonds as US settlement nears-WSJ	b
'Dancing with the Stars' Recap: Season 18, Episode 1	e
Offshore cash of $2 trillion sparks hunt for tax-friendly deals	b
Brad Pitt Just Got Punched in the Face at the Maleficent Premiere	e
Good News! Big Gulps Are Okay Again In New York City	m
Say goodbye to tax-free bitcoins	b
US stocks rise on Citi earnings, retail sales	b
Dollar trades at lower 101 yen in early Tokyo trading	b
US Airways rushed out an apology Monday after a graphic sexual image was  ...	e
Rumors about the Samsung Galaxy Note 4′s camera emerge	t
Baton Rouge-based Amedisys agrees to pay $150 million settlement	m
Bow to the Dow	b
Free skin cancer screenings	m
Oldman comes to defense of Gibson, Baldwin	e
Go beyond flowers with these weird Mother's Day gifts	e
UCLA's Pauley Pavilion drenched in hoops history	b
Penis-cutting rapper 'on Angel Dust'	e
Amazon offers authors e-book proceeds	b
Motorsports - Helicopter firm files complaint over Schumacher records	m
Canada's Dollar Fluctuates After Growth Trails Forecast	b
Samsung Galaxy S6 Rumor Train Starts Chugging as Galaxy S5 Release Date  ...	t
S&P says affirms BNP's long-term credit rating, outlook negative	b
Richard Gere dating Indian beauty Padma Lakshmi	e
Nissan says full-year profit jumps 14.0% to US$3.8b	b
Wu-Tang Clan to Auction Only One Copy of Top Secret Album 'Once Upon A  ...	e
Samsung's shotgun approach to selling phones fails in Q2	b
'The Other Woman': Formulaic farce falls short	e
Kourtney Kardashian Pregnant With Baby Number Three?	e
This week's television highlights	e
Aaron Taylor-Johnson Says Godzilla 2 Could Pull From Jaws Inspirations	e
Noah nude shoot poses problems for Crowe	e
Violence Erupts At BET Awards Parties	e
Samsung Galaxy S5 Copper Gold pictures and hands-on	t
Samsung Galaxy Tab S 10.5 release date, price and specs: new Samsung tablet  ...	t
Facebook Secret Study	t
Cause of GWAR frontman's death revealed: Shock rocker Dave Brockie AKA  ...	e
Jury leaves damages Samsung must pay Apple unchanged at $119.6 mln	t
The Trailer for Ben Affleck and David Fincher's Gone Girl Hits	e
Samsung unveils Galaxy S5 in India, available from April 11	t
Commerce Department easing federal rules on US oil exports	b
SAC record $1.8-bn insider plea caps 7-year probe	b
Dear Sheryl Sandberg: There Are Far Worse Things Than Being Called Bossy	e
Mobileye shares jump 58 pct in bumper debut	b
After MH370 disappears, Inmarsat offers free tracking	b
Halle Berry Lands on TV for 'Extant'	e
New Lifetime High Reached By Integrys Energy Group (TEG)	b
Some Moving Video Footage From The New 9/11 Museum	e
FTSE 100 watch: Weak China PMI weighs on Footsie	b
Draghi: Cramped credit hurting recovery	b
"Zac Efron: Being Open About Rehab is ""A Giant Weight Off My Chest"""	e
Nicolas Cage Dishes On His Tortured Character In 'Joe': Watch	e
Spider-Man stars grace red carpet in London	e
Shia LaBeouf's Ample Collection of Dirty Tees	e
No access to Play store	t
Ronnie Wood: L'Wren Scott Death 'Devastating'	e
Neil Young will be launching New Music Player tomorrow	e
Outrage: Barack Hussein Obama Bows to Japanese Robot: Video	t
Gas prices in Rhode Island down a penny to $3.59 a gallon; just over the  ...	t
Justin Bieber Under Investigation For Attempted Robbery At Dave & Buster's	e
Gary Oldman: Dreyfus is a hero	e
Tech Five: Microsoft steady following tablet reveal	t
Recall wipes out GM profits	b
Adobe releases Voice – free app for video storytelling	t
Diabetes Related Health Complications Lower Among U.S. Adults	m
Seven fruit and veg portions a day saves lives, say experts	m
Justin Bieber Deposition Videos Go Online	e
Bachelorette Bombshell: Andi Dorfman Chooses Her Man And Nick Viall Shocks  ...	e
After 10 Years, Sony Discontinues PSP -- What's Your Favorite Memory?	t
FDA backpedals on cheese board ban	m
VIDEO: BBC America's ORPHAN BLACK - Season 2 Begins Tonight	e
"Kaley Cuoco Fools the Internet, ""Cracking Up"" at Drastic Haircut Reports"	e
Solange Knowles (kinda) Addresses Elevator Scuffle with Jay Z	e
The Geezer - No Woman Should Beat a Geezer and Go Unscathed	e
Critical zero-day endangers all versions of Internet Explorer -- and XP isn't  ...	t
Acadia Healthcare Company Inc.: Acadia Healthcare Signs Definitive Agreement  ...	m
Germany beats France 1-0 to reach World Cup semifinals	b
Nollywood Contributes Massively To Nigeria's GDP - Ventures Africa	b
April 15 not much of a deadline for most taxpayers these days	b
Zach Braff: Don't over-complicate movies	e
VIDEO: Pat Sajak spins climate change on Twitter	e
Alicia Keys Announces 2nd Pregnancy on Instagram	e
Popular soft drinks to drop controversial ingredient	b
SIGN POST: Sweet jam in the smartphone sarmie	t
Robert De Niro - Robert De Niro talks about gay father	e
Windows 8.1 Update 2 rumored for September 9 launch	t
CORRECTED-UPDATE 3-Candy Crush maker King Digital shares sour in  ...	b
China GDP growth slows to 7.4 per cent in Q1	b
EU bank chief: More banks will be fined following record $9bn penalty for BNP	b
Miranda Lambert's New Album Examines Life At 30	e
Why the merger of ATK and Orbital Sciences makes sense	b
Will Arnett files for divorce from Amy Poehler, 18 months after their separation  ...	e
'Sons of Guns' Star Will Hayden Arrested for Violating His Daughter 'Almost Daily'	e
Placenta is not as sterile as once thought, it contains bacteria, viruses and fungi	m
Love and 'The Normal Heart'	e
Microsoft-Nokia Deal Closing Friday With Changes	t
Some US airlines drop limes from beverage service	b
Call of Duty: Ghosts - Bringing MW3's Dome to Next-Gen	t
Turn off the stove with your iPhone	t
Pink Floyd to release 1st new album since 1994	e
HTC One vs LG G Pro 2 – Battery Life, Display, Design & Prices	t
Sales of US homes slip to 20-month low	b
US economic-growth rate in last quarter revised higher	b
Neil Patrick Harris Unveils Cover For 'Choose Your Own Autobiography'	e
Colonoscopy Is Good, Not Perfect	m
Roll Call: The Decepticons of Transformers: Age of Extinction	e
UPDATE 2-Nestle sees faster growth after weak start to year	b
Toyota pays record $1.2bn penalty for covering up defects	t
Nasa's New Horizons Spacecraft to Probe Pluto's Moon Charon For Ancient  ...	t
Brothers disappointed that HGTV canceled their show	e
Airbnb and Uber Partner with Concur to Enable Next Generation of Business  ...	b
BBB Warning: Here's What to Do About “Heartbleed” Bug	t
JPMorgan's Jamie Dimon Has Throat Cancer	b
China's foreign trade down	b
Gold holds above $1300 ahead of Fed meeting	b
ATTENTION! Robert Pattinson is homeless and looking for somewhere to stay!!	e
U.S. new home sales rise by most in six months	b
Producer prices rise 0.5% in US	b
Russian factory activity shrinks for 8th straight month in June: PMI	b
Sony Xperia Z2 Tablet review	t
NASA spacecraft completes mission with planned lunar impact	t
Hillary Clinton to appear on Fox News to promote new book, talk about Benghazi	b
Baby North victim of racial attack	e
Amazon Appstore Selection Nearly Triples Year-Over-Year	t
Microsoft develops 'universal translator'	t
Shell share price: Company cuts stake in Australia's Woodside	b
E-cigarette study finds they affect the lungs in a similar way to tobacco	m
Dollar Stabilizes After Rough Week	b
New, noninvasive, stool-based colorectal cancer screening test	m
Euro struggles near 1-year low on weak German data, Draghi's comments	b
'Homeland' actor James Rebhorn, prolific film and TV star, dies at 65	e
Drug recalled after different pills found in its bottles	m
Heartbleed bug claims its first victim	t
Worse global warming effects ahead for Texas, federal report says	t
Roku Makes The 3500R Streaming Stick Official With Todays Launch	t
Are you a newbie to Record Store Day? Here are some tips on scoring some  ...	e
What's News—	b
Obamacare gives boost to Medicare, but more needed	b
New study reveals a startling distrust of modern technology among Americans	t
Oracle Reports GAAP EPS up 8% to 56 Cents, Non-GAAP EPS up 5% to 68 Cents	b
Carney Relocation to London Cost More Than 100000 Pounds	b
2014 MTV VMAs Winners List	e
Sherlock Season 4: Martin Freeman Reveals Show's Possible Return Date and  ...	e
French fraud case: IMF's Lagarde under investigation	b
OkCupid CEO Responds to Anti-Gay Donation Controversy	t
Marvel releases Avengers: Age Of Ultron concept art	e
Analyst: GM may offer $2B-plus to settle recall claims	t
Fiery crash that killed actor Paul Walker attributed to 'unsafe speed'	e
Latimer: University study sheds light on autism	m
ABC Confirms Frozen Cameo In Once Upon a Time	e
AstraZeneca bid by Pfizer now over	b
Frankfurt Stocks Finish Markedly Lower	b
Portland issues largest boil water alert ever	m
PlayStation 4 follows Xbox One into China	t
Cockpit 'mismanagement' blamed in Asiana crash	b
PS4 VS Xbox One: PlayStation 4 Sales Had A Small Lead In US Before Titanfall  ...	t
THIS Mediterranean Diet Food Combo May Help Your Heart	m
Air Quality Has Improved In US, Says NASA	t
Amy Adams offers her first class plane seat to soldier	e
NASA Reaches Deal With Boeing to Build Deep Space Rockets	t
Alzheimer's disease will strike 1 out of 6 older women, study says	m
RPT-Alstom should be a good investment for France, says CEO Kron	b
“Girls” star Allison Williams to play Peter Pan in live NBC production	e
McDonald's Declares An All-Out Breakfast War Against Taco Bell! See The Shots  ...	b
Google I/O Gets Positive Reviews From Analysts	t
Justin Bieber gets rear-ended in his $230000 Ferrari	e
Mayors Unanimously Pass Climate Resolution	t
Windshield washer fluid a source of Legionnaires	m
Trace Adkins Divorce: Wife Rhonda Divorcing Trace After Drunk Relapse and  ...	e
Valeant increases offer for Botox maker Allergan to $49.4bn	b
Movie review: 'Tammy' is Melissa McCarthy run amok	e
"LOS ANGELES (AP) — Edgar Wright and ""Ant-Man"" are going their separate ways."	e
The U.S. home sales declined unexpectedly	b
13 Things You Probably Didn't Know About Miley Cyrus	e
SAP alters data warehousing with Business Warehouse 7.4	t
Mickey Rooney wife Jan Chamberlin learned of husband's death online (Photo)	e
Lanzhou Gov't Takes Emergent Measures to Supply Free Water to Residents	b
Mila Kunis 'pregnant with first child'	e
'The Interview' is just latest parody of Kim Jong Un	e
People prefer friends with similar DNA	m
Google Hangouts – Learn to Download for Free and Make the Most of the App	t
Thriller from beyond grave: New Jackson songs wow critics	e
McKinley co-sponsors Medicare legislation	m
Karrueche Tran says sorry after mocking Blue Ivy's hair… blames TV show for  ...	e
Paul Mazursky, 5-time Oscar nominee, dies	e
iPhone 6 leaks: Images reportedly from Foxconn show Apple's next-gen  ...	t
St. John United Church of Christ Holy Week services	e
Colorado becomes first state to approve bill giving terminally ill access to  ...	m
Alibaba Goes For NYSE And Not Rival Nasdaq	b
Cameron softens tone on Pfizer deal as boss flies in	b
VLC launches on Windows 8 in beta following Kickstarter success	t
Google designs self-driving car	t
European Uber protest headed for Trafalgar Square	b
Facebook cracking down on 'clickbait' with update	t
Frankie Knuckles, Godfather of House Music, dead at 59	e
Robert Downey Jr. and Mark Ruffalo share 'Avengers: Age of Ultron' set pics	e
GM chief apologizes for deaths from flaws	b
Asia shares down before China inflation data	b
Actor's mom seeks guardianship of grandchild	e
Tracy Baxter: Confusing state laws on fireworks spark debate	e
Barbara Walters: ABC plans May 16 sendoff	e
Pop star *Justin Bieber *has apologised for telling a racist joke when he was 15.	e
The Hottest Stories Right Now!	e
A Little Positivity! Tracy Morgan Showing Signs Of Improvement After Car  ...	e
The Yves Behar Designed Vessyl Cup Launches, Tracks What You Are Drinking	t
Why you should care about open internet: Net neutrality and internet fast lanes  ...	t
Flight 370 search: Thai satellite identifies hundreds of objects in Indian Ocean	b
Alien Isolation will feature Sigourney Weaver and original Alien cast	e
FDA grants Priority Review for Roche's Avastin Drug	m
Kanye West and Kim Kardashian plan North's first birthday	e
27/08/2014IMF chief Lagarde's legal woes: a timeline	b
Cristina Says Goodbye to 'Grey's Anatomy': Season Finale Recap!	e
Vietnam accuses Chinese ship of sinking fishing boat	b
Google Secures All Emails With HTTPS To Keep NSA Out [VIDEO]	t
VA Releases Findings On Deaths, Injuries From Delayed Tests	m
Get the iPhone 5S for a free seven-day trial with T-Mobile Test Drive	t
Applications for US unemployment benefits edge up	b
Dogs sniff out prostate cancer	m
Taco Bell Creates a New Fast-Casual Brand	b
Can claims data crack the health care cost riddle?	m
Justin Beiber Deletes Selena Gomez Tweet	e
Legal settlement restricts marketing of Four Loko alcoholic drinks	m
US Jobless Aid Applications Rise to 304000	b
EBA Stress Test 2014 - Final Methodology And Scenarios Released	b
'Yeah but it feels good, dunnit?'	e
Google Maps for Android improves navigation for cyclists and drivers	t
'The Bachelorette' 2014 spoilers: What goes down during 'Men Tell All' episode	e
Germ-killing ingredient banned	m
Darden to Sell Red Lobster, Retain Olive Garden	b
Stocks Hold Steady Ahead of FOMC Statement	b
Update Samsung Galaxy Note 3 N900 to Android 4.4.2 KitKat Assassin Custom  ...	t
Miley Cyrus Rebounds Up Social 50 Chart	e
Wichita man prays for mom who contracted Ebola	m
Robert Downey Jr. son arrested for cocaine possession	e
Spirit Airlines sucks hardest in new complaints survey, but Frontier's gaining fast	b
Second Opinion - Captain America: The Winter Soldier (2014)	e
'Candy Crush' to be Released in China by Tencent	b
'Heartbleed' bug fix may slow Internet performance	t
BMW confirms new X7	b
Colin Firth leaves 'Paddington,' picks 'conscious uncoupling' while recording lines	e
Valeria Lukyanova is anti-kids: 'Human Barbie' admits racism in GQ interview	e
Google's wacky new Cardboard project could help take virtual reality mainstream	t
ASX 200: weekly market wrap	b
Dolce & Gabbana's guilty verdict for tax evasion held up in Italian court	e
Relay for Life survivors' dinner set for Thursday	m
Stock futures declining; AT&T to acquire DirecTV; AstraZeneca rejects Pfizer  ...	b
Clinton to Geithner: Slit Blankfein's throat? Nah	b
Samsung profit may slip again in second quarter	b
Twitter Inks $230M Mobile Ad Deal With Omnicom	b
John Hamm and Paul Rudd in 2009	e
Glass all gone after one-day sale, Google says	t
Dutch police arrest six Greenpeace activists over oil rig demos	b
China first-quarter growth slows to 7.3%: AFP survey	b
Want to Upload Your Brain? How Johnny Depp's 'Transcendence' Comes to Life	e
PlayStation 4 coming to China in the future	t
Kanye West Goes On Another Round Of Self-Exaltation In New Rant	e
Johnny Depp desires to have 100 more children	e
Chrysler Group Reports Loss of $690 Million in First Quarter	b
"Get Cameras Ready To Capture ""Supermoon"""	t
DIG Now: 'Game of Thrones' returns for season four	e
Astronomers discover a 'Godzilla' of Earths	t
Washington state issues marijuana shop licenses	b
NASA finds habitable 'Earth-like' planet	t
Bershidsky: More vacation or a four-day work week?	t
Saudi Arabia takes heat for spread of MERS virus	m
Oregon jobless rate lowest since 2008	b
Lawmakers have bigger tax woes than IRS workers	b
Tesla Motors Inc shares surge after U.S. safety regulator investigating fires finds  ...	t
Twitter's Earnings: What to Watch	b
What a difference a year makes for Kim Kardashian	e
Another View: 'Right to be forgotten' by Google may be useful EU experiment	t
Google developer conference in San Francisco begins	t
Sun worshippers see spike in cases of skin cancer (w/video)	m
Floyd Mayweather and rapper T.I. brawl at Las Vegas' Fatburger	e
Jay Z and Beyoncé Knowles didn't attend Kanye West's wedding.	e
Chris Christie not going to miss David Letterman	e
Brent up near $113 on supply worries as Iraq violence rises	b
Apple punches holes in the walled garden with iOS 8	t
Dow and S&P 500 bosted	b
Traditional political discourse undermines scientific progress	m
Game Of Thrones Season 4 Finale: Let's Talk About That Ending	e
'Godzilla' Director Gareth Edwards To Helm First Stand-Alone 'Star Wars' Film	e
7/2 - CNN Business: T-Mobile Accused of Bogus Charges	t
Freshwater from the Colorado River After 16 years	t
Microsoft fights off US efforts to access data stored abroad	t
Mr. Son Comes To Washington With Big Broadband Vision But Few Facts	t
Will the Oculus Buy Give Facebook a Leg Up?	t
Ikea raises hourly pay for retail workers	b
BMO Harris Bank: Monday's Mortgage Interest Rates Mar 17	b
Utah dinosaur tracks go on display this fall	t
India central bank leaves rates on hold; election, monsoon in focus	b
U.S. retail sales rise modestly; Nevada official upbeat about '14	b
Asiana airlines crash caused by pilot error and confusion, investigators say	b
Is Lana Del Rey performing at KimYe's wedding?	e
Smoking bans cut asthma attacks and premature births by 10 percent, study says	m
Family first, career second for Kim Kardashian	e
The Easter Bunny is a rabbit who lacks a tale	e
Robert Morse talks his musical, final 'Mad Men' scene	e
Tesla reaches deal with Ohio auto dealers	b
Edgar Wright Leaves Marvel's 'Ant-Man' As Director Over 'Differences In Their  ...	e
3000 Toyota Jobs to Move to Texas from California	b
Antidepressant Use During Pregnancy Linked To Autism In Boys	m
New ISU study answers: Is that morning run really worth it?	m
Wall St falls in broad selloff	b
Shares of Coca-Cola pop after strong China sales boost revenue	b
UPDATE 1-NY state joins NYC in suing FedEx over untaxed cigarettes	b
Beyonce Divorce Update: Jay-Z Cuts Off All Contact With Rachel Roy, Runs To  ...	e
'How I Met Your Mother' Finale Spoilers: Robin-Barney Divorce; Mother Dies	e
Why Minnesota Fed Chief Kocherlakota Broke Ranks	b
Angry Birds Transformers rolls out later this year	e
Target publishes letter asking customers to not shop with guns	b
Samsung Galaxy S5 Dx (mini) leaked, maybe on purpose	t
How to minimize risk of skin cancer in summers	m
Emma Roberts reveals horror fears	e
Lawyer hired by NC in probe represented Duke	b
Spotify hits 10 million Premium subscribers milestone	e
Will Queen Bey reign supreme? Beyonce leads MTV Video Music Awards with  ...	e
Kim Kardashian Steps Out With Bleached Blond Hair — See the Dramatic Look  ...	e
Bryan Singer faces second lawsuit for sexual assault	e
Teen raped at Keith Urban concert, dozens more arrested and hospitalized	e
TV on Tap: Sean Hayes Joins “The Millers,” IFC Wants More “Spoils” and  ...	e
Star Wars Fans Given Chance To Be In New Film	e
Factory production: HSBC manufacturing PMI sees fastest growth in India since  ...	b
Samsung Galaxy S4 vs HTC One – Battery Life, Display, Design & Prices	t
Tesco reports 6% profit fall	b
Jayonce alert! Music's first couple to go on tour together this summer	e
Bardarbunga Volcano Update: Iceland Retracts Eruption Alert But Continues  ...	t
This Rotten Week: Predicting Maleficent And A Million Ways To Die In The West  ...	e
Wal-Mart To Offer Money-Transfer Service	b
"Arch Campbell Show: Melissa McCarthy delivers laughs in ""Tammy"""	e
Fast Food Workers Will Go on Strike Next Week	b
Why Zogenix Inc. Stock Tumbled	m
US regulators probe allegations of 'pyramid scheme' at Herbalife	b
US government green-lights data swapping for security firms	t
Vessyl iOS-connected smart cup analyzes, tracks what you drink	t
Comic-Con International 2014	e
Facebook making big changes to its advertisements	t
Daisy Ridley: Everything You Need To Know About Star Wars' New Leading Lady	e
White House touts Medicaid expansion for Texas	m
Taylor Swift Continues Holiday Weekend Celebrations with Emma Stone  ...	e
Yahoo Shows Positive Signs With Q1 Earnings, Stock Rises YHOO	b
Crimean annexation illegal, UN General Assembly says	b
Gaithersburg biotech believes it has vaccine to fight MERS	m
Conn. Exchange Chief To Run Healthcare.gov	m
WWE Stock Takes Huge Hit After Network Numbers Come Out, WWE  ...	t
IG: La. collected $7M too much in enrollment bonus - WHLT 22 Connecting the  ...	m
Ebola outbreak in Africa has minimal impact so far on educational exchanges	m
Greater usability for iWork and more news from April 1, 2014	t
Chris cheated on Gwyn: report	e
Credit Card Information Stolen: California DMV Targeted	b
Long-nosed 'Pinocchio rex' dinosaur discovered by scientists	t
FTC: T-Mobile netted 'hundreds of millions of dollars' in fraudulent premium SMS  ...	t
Longmont's Twin Peaks Golf Course back from flood, ready for play	e
2014 Mercedes-Benz C-Class holds advantage over competition	t
Box Office: '22 Jump Street' hits #1, 'Dragon 2′ takes #2	e
Brent Trades Near Nine-Month High on Iraq Violence; WTI Gains	b
Bob Hastings, star of 'McHale's Navy,' dies at 89	e
Aus fans welcome Harry Potter update	e
Title for Batman Vs Superman confirmed	e
Closure of I-495 bridge in Delaware causes heavier traffic for motorists on I-95	b
SpaceX's land investments grow	t
Pfizer Experimental Drug Shows Promising Results in Phase II Study	m
Covered California Announces Rates For 2015	b
Ready for icy challenge	e
TIMELINE: Fox and Corso	b
Mortgage Rate Summary for HSBC, BMO Harris Apr 17	b
Darden Restaurants to sell Red Lobster to Golden Gate Capital for $2.1 billion	b
Why Should I Hate The AT&T-DirecTV Merger? – The Why	t
AT Rejects Netflix Call For Free Interconnection As Unfair	t
AT&T pushed by Comcast to move on DirecTV	t
Russia, China Agree On $25B Prepayment Under Supply Deal: Gazprom	b
Earth to get first look at meteors from 'new' comet	t
Miley Cyrus goes raunchy, puts mouth around giant inflatable penis	e
Will Microsoft Mobile Be The New Threat To Google Android And Apple?	t
Samsung Galaxy S3 & S3 Mini May Rejoice In KitKat Soon	t
Ebola epidemic likely to last months: UN	m
Oscar-Winning Gandhi director Richard Attenborough dies at age 90	e
Amazon Launches Dubious Music Streaming Service	e
Arizona Weekly Gas Price Update and Outlook	t
"Tom Cruise Says Triple ""Edge of Tomorrow"" Premieres Were Tough"	e
SpaceX cargo ship attached to space station	t
Kim Kardashian Marrying Kanye West This Week?!	e
US airlines pilot says he almost crashed into a drone in mid-air	b
Apple conditionally agrees to $450 million settlement in e-book price fixing suit	t
Carney hints at imminent interest rate rises	b
Samsung Galaxy S6 Visualization Is As Awesome As It Sounds	t
Melissa Mccarthy - Melissa McCarthy: Susan Sarandon's gorgeous ankles	e
Deadly MERS virus migrates to the US but no need to get alarmed, says CDC	m
Tesla Motors Gets Small Victory, Can Keep its Electric Car Stocks in New York  ...	b
Ford injury halts 'Star Wars' production	e
Presidential Daily Brief for June 16, 2014	b
Police sent to enforce car ban as Paris battles smog	t
S&P 500 notches first-ever close above 1900	b
French Montana Buys Khloe Kardashian a $49K Car For Her Birthday — Report  ...	e
Citigroup reaches mortgage settlement	b
Fourth of July Gasoline at Six-Year High	b
The world economy may well be stuck in neutral for years	b
WHO Warns of Polio Comeback	m
Microsoft latest US tech target in Beijing	t
Allergan, Inc. (NYSE:AGN) To Offer New Takeover Bid ToShire PLC (ADR  ...	b
Crowds Gather for Fourth of July Fireworks in NYC	e
Winter Sleep wins Palme d'Or	e
Choosing a place to land NASA's next Mars rover	t
Study Blames Rap Music For Teens Driving Drunk	m
Alibaba Opts for New York Stock Exchange	b
4000 Pounds of Beef Recalled for Mad Cow Disease, Some at Whole Foods	m
A breakdown of the latest Apple-Samsung dustup	t
BMW - Bayerische Motoren Werke AG: BMW Group looks ahead to 2014 with  ...	b
Apple reportedly closing in on 3.2bn USD Beats buyout	t
Get in the habit of changing your passwords often	t
Syria chemical weapons moved to US ship in Italy	b
Brian Williams Raps 'Gin and Juice'	e
First SM-3 Launch for Aegis Ashore	b
The Voice crowns season 6 winner	e
Nintendo Revealed Its New Figurine Platform For 3DS & Wii U	t
